1111111111111111111111111111111111
1E1001C00000010C001000000000000001
1010011110100100101001111111111101
1010010010101110001011001C00010101
1P0000000010C0000000C10000000000C1
1111111111111111111111111111111111
