1111111111111111111111111111111111
100000C00000000000000000C000000001
10P0000000000C00000D000000C0000001
10000000000000000000000000000000C1
10000C000000000000000000D000000001
100000000000000D00000000000D000001
1C00D00000000000000000000000000001
1000000000000000000000000D00000001
100D00000C000D00000000000000000001
1000000000000000000C00000000D00001
100000000C00000D000000000000000D01
1000C0000000D00000000C0000000C0001
100000000D000000000C0000D0000C0001
100000000000D000000000000000000001
1000000D000000000000000D0000000001
1000D000000000D00000000000000C0001
100000000000000000D000000000000001
1C00000C00000000000000000000000E01
100C000000D000000C000000D000000C01
1111111111111111111111111111111111
